02 01 01 01 01 01 01 01 01 01 01 01 01 27 27 01 01 01 01 01 01 01 01 01 01 01 01 05
00 40 40 40 40 40 40 40 40 40 40 40 40 29 29 40 40 40 40 40 40 40 40 40 40 40 40 00
00 40 08 07 07 11 40 08 07 07 07 11 40 29 29 40 08 07 07 07 11 40 08 07 07 11 40 00
00 40 06 41 41 06 40 06 41 41 41 06 40 29 29 40 06 41 41 41 06 40 06 41 41 06 40 00
00 40 09 07 07 10 40 09 07 07 07 10 40 30 30 40 09 07 07 07 10 40 09 07 07 10 40 00
00 40 40 40 40 40 40 40 40 40 40 40 40 40 40 40 40 40 40 40 40 40 40 40 40 40 40 00
00 40 25 24 24 26 40 31 31 40 25 24 24 38 38 24 24 26 40 31 31 40 25 24 24 26 40 00
00 40 25 24 24 26 40 29 29 40 25 24 24 38 38 24 24 26 40 29 29 40 25 24 24 26 40 00
00 40 40 40 40 40 40 29 29 40 40 40 40 29 29 40 40 40 40 29 29 40 40 40 40 40 40 00
03 01 01 01 01 05 40 37 37 24 24 26 41 29 29 41 25 24 24 36 36 40 02 01 01 01 01 04
41 41 41 41 41 00 40 37 37 24 24 26 41 30 30 41 25 24 24 36 36 40 00 41 41 41 41 41
41 41 41 41 41 00 40 29 29 41 41 41 41 41 41 41 41 41 41 29 29 40 00 41 41 41 41 41
41 41 41 41 41 00 40 29 29 41 18 01 17 15 15 16 01 21 41 29 29 40 00 41 41 41 41 41
01 01 01 01 01 04 40 30 30 41 00 41 41 41 41 41 41 00 41 30 30 40 03 01 01 01 01 01
41 41 41 41 41 41 40 41 41 41 00 41 41 41 41 41 41 00 41 41 41 40 41 41 41 41 41 41
01 01 01 01 01 05 40 31 31 41 00 41 41 41 41 41 41 00 41 31 31 40 02 01 01 01 01 01
41 41 41 41 41 00 40 29 29 41 19 01 01 01 01 01 01 20 41 29 29 40 00 41 41 41 41 41
41 41 41 41 41 00 40 29 29 41 41 41 41 41 41 41 41 41 41 29 29 40 00 41 41 41 41 41
41 41 41 41 41 00 40 29 29 41 25 24 24 38 38 24 24 26 41 29 29 40 00 41 41 41 41 41
02 01 01 01 01 04 40 30 30 41 25 24 24 38 38 24 24 26 41 30 30 40 03 01 01 01 01 05
00 40 40 40 40 40 40 40 40 40 40 40 40 29 29 40 40 40 40 40 40 40 40 40 40 40 40 00
00 40 25 24 35 35 40 25 24 24 24 26 40 29 29 40 25 24 24 24 26 40 32 32 24 26 40 00
00 40 25 24 35 35 40 25 24 24 24 26 40 30 30 40 25 24 24 24 26 40 32 32 24 26 40 00
00 40 40 40 29 29 40 40 40 40 40 40 40 41 41 40 40 40 40 40 40 40 29 29 40 40 40 00
23 24 26 40 29 29 40 31 31 40 25 24 24 38 38 24 24 26 40 31 31 40 29 29 40 25 24 22
23 24 26 40 30 30 40 29 29 40 25 24 24 38 38 24 24 26 40 29 29 40 30 30 40 25 24 22
00 40 40 40 40 40 40 29 29 40 40 40 40 29 29 40 40 40 40 29 29 40 40 40 40 40 40 00
00 40 25 24 24 24 24 39 39 24 24 26 40 29 29 40 25 24 24 39 39 24 24 24 24 26 40 00
00 40 25 24 24 24 24 39 39 24 24 26 40 30 30 40 25 24 24 39 39 24 24 24 24 26 40 00
00 40 40 40 40 40 40 40 40 40 40 40 40 40 40 40 40 40 40 40 40 40 40 40 40 40 40 00
03 01 01 01 01 01 01 01 01 01 01 01 01 01 01 01 01 01 01 01 01 01 01 01 01 01 01 04 

   